1
111111111111111
100000000000001
111111111111101
121110000001101
100010101001101
101110000000101
101111111111101
100000000000001
111100010011101
111100010010001
100001110010001
111111111111111