1
1111111111111
1010001001111
1010101001111
1010001011002
1000001000011
1111101011111
1000100000011
1000001100001
1111111111111