1
1111111111
1010001001
1010101002
1000100011
1111111111