1
11111111111111111111
10000101010001000011
10000101010111010101
10000101010001001001
10000100000000000101
10000111101111110111
11110100000000110121
10100101111111010101
10100101000001010101
10110101001001010101
10010101001001010101
10110101101001010101
10100101011111010101
10110100000000010001
10010111111111110101
10010000100010000101
10111110101000101101
10000000000010001001
11111111111111111111


