1
1111111111
1012000001
1011110001
1001001001
1100100101
1010001101
1000001001
1100010001
1000100001
1000011101
1000000101
1000011101
1011100001
1000000001
1111111111