1
111111111111111111
100000000000000001
111101111010100101
100000001010100101
101000101110000101
101001000010000001
101010001011110101
100011101000000101
111010001110110101
100011111000010101
101000001000000101
111111111112111111